########
#PAAAAG#
#FLLFDF#
#AFFFBA#
#FAAAAA#
#AAAFAA#
########
