######
#PAAG#
#FLDF#
#AFBA#
#FAAA#
#AAFF#
######
