##########
#AAAAAAAA#
#AAAAAAAF#
#AAALFAAF#
#AALFFAAA#
#PLFFAAAA#
#FFAGALAA#
#AAAFDFBA#
##########
