############
#AAAPAAAAAA#
#{]A[-]AAAA#
#LAAAAIAAAA#
#LA[D--O]AA#
#LAAAGA[-]A#
#[}A[]AAAAA#
#[--------]#
############