############
#AAAAPAAIAA#
#AA[--D-]AA#
#AAAAGAAAAA#
#AAAA[-]AAA#
#=AAAAAAAAA#
#AA=AAA=A=A#
############
