########
#PAAAAG#
#[OO-D]#
#ALLABA#
#A[--]A#
#=AAAAA#
#AAA=AA#
########
