######
#PAAG#
#[OD]#
#ALBA#
#A[]A#
#AAAA#
#=AAA#
#AAAA#
#AA[]#
######
