##########
#AAAAAAAA#
#AAAAAAA=#
#AAA{]AA=#
#AA{-]AAA#
#P{-]AAAA#
#[]AGA|BA#
#AAA[D-]A#
##########
